 xxxxxxx
 x     x
 x lfl x
xx fzf x
x  lfl x
x      x
xxxxxxxx