 xxxxx
 x   xxxx
 x   x  x
 xx    lx
xxx xxxlx
x f x xlx
x ffx xxx
xz  x
xxxxx